{
  "comments": {
    "0": "empty", "1": "wall", "2": "player", "3": "target", "4": "crate", "5": "create on target"
  },
  "levels": [
    {
      "name": 1,
      "width": 8,
      "height": 5,
      "gameMap": [
        [1,1,1,1,1,1,1,1],
				[1,3,3,4,0,4,0,1],
				[1,3,0,4,0,0,0,1],
				[1,0,1,0,0,0,2,1],
				[1,1,1,1,1,1,1,1]
      ],
      "player": {"x":3, "y":6}
    },
    {
      "name": 2,
      "width": 11,
      "height": 11,
      "gameMap": [
        [0,0,0,1,1,1,0,0,0,0,0],
        [0,0,1,1,0,1,0,1,1,1,1],
        [0,1,1,0,0,1,1,1,0,0,1],
        [1,1,0,4,0,0,0,0,0,0,1],
        [1,0,0,0,2,4,0,1,0,0,1],
        [1,1,1,0,4,1,1,1,0,0,1],
        [0,0,1,0,0,1,3,3,0,0,1],
        [0,1,1,0,1,1,3,1,0,1,1],
        [0,1,0,0,0,0,0,0,1,1,0],
        [0,1,0,0,0,0,0,1,1,0,0],
        [0,1,1,1,1,1,1,1,0,0,0]
      ],
      "player": {"x":4, "y":4}
    },
    {
      "name": 3,
      "width": 9,
      "height": 9,
      "gameMap": [
        [0,1,1,0,1,1,1,1,1],
        [1,1,0,1,1,0,3,0,1],
        [1,0,1,1,0,4,3,0,1],
        [0,1,1,0,4,0,0,0,1],
        [1,1,0,4,2,0,1,1,1],
        [1,0,4,0,0,1,1,0,0],
        [1,3,3,0,1,1,0,1,1],
        [1,0,0,0,1,0,1,1,0],
        [1,1,1,1,1,0,1,0,0]
      ],
      "player": {"x":4, "y":4}
    },
    {
      "name": 4,
      "width": 13,
      "height": 10,
      "gameMap": [
        [0,0,1,1,1,1,1,1,1,1,1,1,1],
        [0,1,1,0,0,0,0,0,1,0,0,2,1],
        [1,1,1,0,4,0,4,4,1,0,0,0,1],
        [1,0,1,1,4,0,0,0,0,4,4,0,1],
        [1,0,0,1,0,0,4,0,1,0,0,0,1],
        [1,1,1,1,1,1,0,1,1,1,1,1,1],
        [1,3,3,0,3,3,4,0,1,0,0,0,0],
        [1,0,3,3,0,0,0,0,1,0,0,0,0],
        [1,0,0,3,3,1,1,1,1,0,0,0,0],
        [1,1,1,1,1,1,0,0,0,0,0,0,0]
      ],
      "player": {"x":1, "y":11}
    },
    {
      "name": 5,
      "width": 8,
      "height": 5,
      "gameMap": [
        [1,1,1,1,1,1,1,1],
				[1,3,3,4,0,4,0,1],
				[1,3,0,4,0,0,0,1],
				[1,0,1,0,0,0,2,1],
				[1,1,1,1,1,1,1,1]
      ],
      "player": {"x":3, "y":6}
    },
    {
      "name": 6,
      "width": 11,
      "height": 11,
      "gameMap": [
        [0,0,0,1,1,1,0,0,0,0,0],
        [0,0,1,1,0,1,0,1,1,1,1],
        [0,1,1,0,0,1,1,1,0,0,1],
        [1,1,0,4,0,0,0,0,0,0,1],
        [1,0,0,0,2,4,0,1,0,0,1],
        [1,1,1,0,4,1,1,1,0,0,1],
        [0,0,1,0,0,1,3,3,0,0,1],
        [0,1,1,0,1,1,3,1,0,1,1],
        [0,1,0,0,0,0,0,0,1,1,0],
        [0,1,0,0,0,0,0,1,1,0,0],
        [0,1,1,1,1,1,1,1,0,0,0]
      ],
      "player": {"x":4, "y":4}
    },
    {
      "name": 7,
      "width": 9,
      "height": 9,
      "gameMap": [
        [0,1,1,0,1,1,1,1,1],
        [1,1,0,1,1,0,3,0,1],
        [1,0,1,1,0,4,3,0,1],
        [0,1,1,0,4,0,0,0,1],
        [1,1,0,4,2,0,1,1,1],
        [1,0,4,0,0,1,1,0,0],
        [1,3,3,0,1,1,0,1,1],
        [1,0,0,0,1,0,1,1,0],
        [1,1,1,1,1,0,1,0,0]
      ],
      "player": {"x":4, "y":4}
    },
    {
      "name": 8,
      "width": 13,
      "height": 10,
      "gameMap": [
        [0,0,1,1,1,1,1,1,1,1,1,1,1],
        [0,1,1,0,0,0,0,0,1,0,0,2,1],
        [1,1,1,0,4,0,4,4,1,0,0,0,1],
        [1,0,1,1,4,0,0,0,0,4,4,0,1],
        [1,0,0,1,0,0,4,0,1,0,0,0,1],
        [1,1,1,1,1,1,0,1,1,1,1,1,1],
        [1,3,3,0,3,3,4,0,1,0,0,0,0],
        [1,0,3,3,0,0,0,0,1,0,0,0,0],
        [1,0,0,3,3,1,1,1,1,0,0,0,0],
        [1,1,1,1,1,1,0,0,0,0,0,0,0]
      ],
      "player": {"x":1, "y":11}
    },
    {
      "name": 9,
      "width": 8,
      "height": 5,
      "gameMap": [
        [1,1,1,1,1,1,1,1],
				[1,3,3,4,0,4,0,1],
				[1,3,0,4,0,0,0,1],
				[1,0,1,0,0,0,2,1],
				[1,1,1,1,1,1,1,1]
      ],
      "player": {"x":3, "y":6}
    },
    {
      "name": 10,
      "width": 11,
      "height": 11,
      "gameMap": [
        [0,0,0,1,1,1,0,0,0,0,0],
        [0,0,1,1,0,1,0,1,1,1,1],
        [0,1,1,0,0,1,1,1,0,0,1],
        [1,1,0,4,0,0,0,0,0,0,1],
        [1,0,0,0,2,4,0,1,0,0,1],
        [1,1,1,0,4,1,1,1,0,0,1],
        [0,0,1,0,0,1,3,3,0,0,1],
        [0,1,1,0,1,1,3,1,0,1,1],
        [0,1,0,0,0,0,0,0,1,1,0],
        [0,1,0,0,0,0,0,1,1,0,0],
        [0,1,1,1,1,1,1,1,0,0,0]
      ],
      "player": {"x":4, "y":4}
    },
    {
      "name": 11,
      "width": 9,
      "height": 9,
      "gameMap": [
        [0,1,1,0,1,1,1,1,1],
        [1,1,0,1,1,0,3,0,1],
        [1,0,1,1,0,4,3,0,1],
        [0,1,1,0,4,0,0,0,1],
        [1,1,0,4,2,0,1,1,1],
        [1,0,4,0,0,1,1,0,0],
        [1,3,3,0,1,1,0,1,1],
        [1,0,0,0,1,0,1,1,0],
        [1,1,1,1,1,0,1,0,0]
      ],
      "player": {"x":4, "y":4}
    },
    {
      "name": 12,
      "width": 13,
      "height": 10,
      "gameMap": [
        [0,0,1,1,1,1,1,1,1,1,1,1,1],
        [0,1,1,0,0,0,0,0,1,0,0,2,1],
        [1,1,1,0,4,0,4,4,1,0,0,0,1],
        [1,0,1,1,4,0,0,0,0,4,4,0,1],
        [1,0,0,1,0,0,4,0,1,0,0,0,1],
        [1,1,1,1,1,1,0,1,1,1,1,1,1],
        [1,3,3,0,3,3,4,0,1,0,0,0,0],
        [1,0,3,3,0,0,0,0,1,0,0,0,0],
        [1,0,0,3,3,1,1,1,1,0,0,0,0],
        [1,1,1,1,1,1,0,0,0,0,0,0,0]
      ],
      "player": {"x":1, "y":11}
    },
    {
      "name": 13,
      "width": 8,
      "height": 5,
      "gameMap": [
        [1,1,1,1,1,1,1,1],
				[1,3,3,4,0,4,0,1],
				[1,3,0,4,0,0,0,1],
				[1,0,1,0,0,0,2,1],
				[1,1,1,1,1,1,1,1]
      ],
      "player": {"x":3, "y":6}
    },
    {
      "name": 14,
      "width": 11,
      "height": 11,
      "gameMap": [
        [0,0,0,1,1,1,0,0,0,0,0],
        [0,0,1,1,0,1,0,1,1,1,1],
        [0,1,1,0,0,1,1,1,0,0,1],
        [1,1,0,4,0,0,0,0,0,0,1],
        [1,0,0,0,2,4,0,1,0,0,1],
        [1,1,1,0,4,1,1,1,0,0,1],
        [0,0,1,0,0,1,3,3,0,0,1],
        [0,1,1,0,1,1,3,1,0,1,1],
        [0,1,0,0,0,0,0,0,1,1,0],
        [0,1,0,0,0,0,0,1,1,0,0],
        [0,1,1,1,1,1,1,1,0,0,0]
      ],
      "player": {"x":4, "y":4}
    },
    {
      "name": 15,
      "width": 9,
      "height": 9,
      "gameMap": [
        [0,1,1,0,1,1,1,1,1],
        [1,1,0,1,1,0,3,0,1],
        [1,0,1,1,0,4,3,0,1],
        [0,1,1,0,4,0,0,0,1],
        [1,1,0,4,2,0,1,1,1],
        [1,0,4,0,0,1,1,0,0],
        [1,3,3,0,1,1,0,1,1],
        [1,0,0,0,1,0,1,1,0],
        [1,1,1,1,1,0,1,0,0]
      ],
      "player": {"x":4, "y":4}
    },
    {
      "name": 16,
      "width": 13,
      "height": 10,
      "gameMap": [
        [0,0,1,1,1,1,1,1,1,1,1,1,1],
        [0,1,1,0,0,0,0,0,1,0,0,2,1],
        [1,1,1,0,4,0,4,4,1,0,0,0,1],
        [1,0,1,1,4,0,0,0,0,4,4,0,1],
        [1,0,0,1,0,0,4,0,1,0,0,0,1],
        [1,1,1,1,1,1,0,1,1,1,1,1,1],
        [1,3,3,0,3,3,4,0,1,0,0,0,0],
        [1,0,3,3,0,0,0,0,1,0,0,0,0],
        [1,0,0,3,3,1,1,1,1,0,0,0,0],
        [1,1,1,1,1,1,0,0,0,0,0,0,0]
      ],
      "player": {"x":1, "y":11}
    }
  ]
}